
###########
#   %  %                                    #
#                                           #
#@   %  %        #                   !     +#
##########             ######################
###########              &###################
#############  ##  ###5######################
#############################################
#############################################
#############################################