# @                         ##
######################     ##
######################     ##
######################     ##
######################     ##
#
#                          ##
#    ########################
#    ########################
#    ########################
#    ########################
#
#
############################