
                !    !     !    !   ! !     !               !
#                                                   ########               #
#                                                     ######               #
#  @           !        !    #####              !   ########               #
#################****####             ###########   #     ##               #
######################## *************************           ######    #####
###################################################################    #####
################################         ##########################    #####
########################              !          # ################    #####
##      ###                !    ###########        ################    #####
#+                   !   ####################***#    ##      ######    #####
###***######***#**#################################                !* *#####
########################################################***#################
############################################################################
############################################################################
############################################################################
############################################################################
############################################################################
############################################################################

