                                              1
                                              #
#                                 1                 ########               #
#                            #   0  #                 ######               #
#  @                    5    ########           !   ########               #
#######        ! ###****####               #######   #     #              &#
######################## *************************           ######    #####
###################################################################    #####
##########1    #################         ##########################    #####
############## ####^^###                         # ################    #####
##      ###                     #### % ####        ################    #####
#+            5          ###########   ######***#    ##      ######    #####
###***######***#**#################################                !*1*#####
############################################################################
############################################################################
############################################################################
############################################################################
############################################################################
############################################################################

