
#                                                   ########               #
#                                                     ######               #
#  @                        #####                   ########               #
#################****####             ###########   #     ##               #
######################## *************************           ######    #####
######################################################**###########    #####
###################################################################    #####
########################                         # ################    #####
##      ###        ####         ###########        ################    #####
##                       ####################***#    ##      ######    #####
###***######***#**#################################                 * *#####
########################################################***#################
############################################################################
############################################################################
############################################################################
############################################################################
############################################################################
############################################################################

