...###.
..##.#.####.
.##..###..#.
##........#.
#...@..#..#.
###..###..#.
..#..#....#.
.##.##.#.##.
.#......##.
.#.....##.
.#######.