#                            #
#                            #
#                            #
#                            #
#                            #
#                            #
#     @                      #
#          *   5   +         #
##############################
##############################
##############################
##############################