#                            #
#                            #
#                            #
#                            #
#                     #      #
#                     #      #
#     @               #      #
#          *   5      #   +  #
##############################
##############################
##############################
##############################