#                            #
#                            #
#                            #
#                            #
#                     #      #
#        ####         #      #
#     @               #      #
#          %   5      #   +  #
##########    #################
##############################
##############################
##############################